10 10
res/sprites/old_man.png
8 8 0.2
res/sprites/flag.png
5 1 1.0
res/sprites/grass.png
10 6 1.0
53 0 53 1 53 2 53 3 53 4 53 5 53 6 53 7 53 8 53 9 53 10 53 11 53 12 53 13 53 14 53 15 53 16 53 17 53 18 53 19
53 0 53 1 53 2 53 3 53 4 53 5 53 6 53 7 53 8 53 9 53 10 53 11 53 12 53 13 53 14 53 15 53 16 53 17 53 18 53 19
53 0 53 1 53 2 53 3 53 4 53 5 53 6 53 7 53 8 53 9 53 10 53 11 53 12 53 13 53 14 53 15 53 16 53 17 53 18 53 19
43 0 43 1 43 2 43 3 43 4 43 5 43 6 43 7 43 8 43 9 43 10 43 11 43 12 43 13 43 14 43 15 43 16 43 17 43 18 43 19
43 0 43 1 43 2 43 3 43 4 43 5
###
10 19 0.9
0 9 0.9
20 29 0.75
22 27 2.0